   WE                            textures/wolfenstein/eagle.xpm 
NO      textures/wolfenstein/grey_stone.xpm



SO textures/wolfenstein/red_brick.xpm

F   69,222,199


      EA     textures/wolfenstein/mossy.xpm



C 235,198,52

111111111111111111111111
100000000000000000000001
101111111111111111111111
100000000000000000000001
111111111111111111111101
100000000000000000000001
101111111111111111111111
100000000000000000000001
100000000000000000000001
100000000000000000000001
10000000000000000E000001
100000000000000000000001
100000000000000000000001
100000000000000000000001
100000000000000000000001
100000000000000000000001
100000000000000000000001
100000000000000000000001
100000000000000000000001
100000000000000000000001
100000000000000000000001
100000000000000000000001
100000000000000000000001
100000000000000000000001
100000000000000000000001
100000000000000000000001
100000000000000000000001
100000000000000000000001
100000000000000000000001
100000000000000000000001
100000000000000000000001
100000000000000000000001
111111111111111111111111
